################
#C#C..........C#
#.###########.C#
#.#....C......C#
#...#.#####...C#
###.#....C#.##C#
#...#######...C#
#......P......C#
#####.....####C#
#C#.....#..C..C#
#.#####.#####.C#
#.#C#.........C#
#.#.#.#.######C#
#.....#......CC#
################